################################################################################
#                                                                              #
#                                                                              #
#          ############################################################        #
#          #           #                                  #           #        #
#          #           #                #                 #           #        #
#          #           #                                  #           #        #
#                 ######         ###############          ######               #
#                                #             #                               #
#                                   #   #   #                                  #
#                                #             #                               #
#          #######################  #   *   #  ########################        #
#                                #             #                               #
#                                   #   #   #                                  #
#                                #             #                               #
#                                ###############                               #
#                 ######                                  ######               #
#          #           #                #                 #           #        #
#          #           #                #                 #           #        #
#          #           #                                  #           #        #
#          ############################################################        #
#                                                                              #
#                                                                              #
################################################################################
################################################################################
#                                     #                                        #
#                                   #####                  #####################
#                                   # * #                                      #
#  #############                    #   #                                      #
#  #           #                    #   #                  ################### #
#  #           #                    #   #                  #                   #
#  #                              #       #                # ###################
#  #           #                    #####                  #                   #
#  #           #                    #   #                  ##################  #
#  #             #####            #   #   #                #                   #
#  #           #       #        #   #   #   #              #  #######  ######  #
#  #           #       #          #   #   #                #                   #
#  #             #####              #   #                  # ###  ###  ###  ####
#  #           #                      #                    # # #  # #  # #  # ##
#  #           #                    #####                  # # #  # #  # #  # ##
#  #                              #       #                # # #  # #  # #  # ##
#  #           #                    #   #                  # # #  # #  # #  # ##
#  #           #                    #   #                  # # #  # #  # #  #  #
#  #############                    #   #                    # #  #      #  #  #
#                                   # * #                      #  #      #  #  #
#                                   #####                                   #  #
#                                     #                                        #
################################################################################
################################################################################
# # # # # # # # # # # # #  ############                                        #
#                           ###########           ######        ######         #
## # # # # # # # # # # # # # ##########             ###           ###          #
#                             #########             ###     #     ###          #
# # # # # # # # # # # # # # #  ########                    ##                  #
#                               #######        #           ##          #       #
## # # # # # # # # # # # # # # # ######        #                       #       #
#                                 #####        #########################       #
# # # # # # # # # # # # # # # # #  ####           #                            #
#                                   ###            ###################         #
# #  #  #  #  #  #  #  #  #  #  #  #     #  #  #  #  #  #  #  #  #  #  #  #  # #
#                                     ###                                      #
#                                     ####       ###               ### ### ### #
#          ###################        #####        #        ###      #   #   # #
#          #                 #        ######     ###         #       #   #   # #
#          # #  #########  # #        #######      #        # #                #
#          # #  #  # #  #  # #        ########   ###         *                 #
#          # #  #       #  # #        #########           #     #   ####  ##   #
#          # #      #      # #        ##########         #       #     #   #   #
#          # ############### #        ###########       ##### ##### ####   #   #
#                                     ############                  #      #   #
#                                     #############                 ####  ###  #
################################################################################
